6	7	3	1	9	8	6	6	9	3
4	1	1	9	1	5	3	9	8	3
1	2	8	7	3	2	6	5	3	3
2	5	5	4	1	5	6	7	3	8
9	1	2	6	4	5	2	5	4	6
6	5	8	4	2	2	6	9	4	2
2	1	9	7	9	9	3	2	8	9
9	7	5	3	8	7	8	5	8	6
3	7	3	8	6	2	3	4	6	7
7	8	6	2	3	9	4	2	6	7
2	8	6	1	4	9	5	2	4	8
7	1	1	4	1	8	4	3	7	7
7	4	3	4	6	1	2	4	5	6
9	4	2	2	3	7	6	8	3	6
8	7	1	6	8	6	8	4	7	7
1	8	2	2	1	3	1	8	9	8
9	5	4	4	7	8	9	9	6	6
7	5	1	2	5	3	5	7	4	7
4	5	7	1	5	9	9	4	4	9
1	1	1	6	9	2	3	3	6	5
5	4	2	3	3	6	2	3	1	5
4	9	6	1	5	7	8	6	2	8
6	4	8	4	8	6	2	9	4	2
5	6	3	3	7	8	7	7	8	1
7	6	5	4	1	9	4	1	9	5
6	8	9	3	7	1	2	8	2	4
4	5	5	4	3	5	4	5	5	3
8	5	1	3	2	1	3	2	3	8
8	8	G	9	5	9	4	4	3	1
8	5	9	7	4	3	2	2	2	S
6	5	3	4	3	1	5	6	6	1
6	8	9	8	1	3	7	6	1	9
7	7	3	3	7	9	7	1	7	2
4	6	2	4	2	1	1	2	5	2
3	8	8	1	3	7	3	4	5	8
