7	4	1	3	1	8	8	5	9	9	5	3	8	8	1	3	3	3	4	9
3	2	3	2	4	3	1	7	5	5	2	8	9	5	8	8	3	7	3	9
4	6	4	5	1	7	6	1	9	4	4	1	1	7	7	5	2	2	9	6
3	6	8	3	7	6	1	1	3	4	2	G	3	9	4	2	4	3	2	8
6	4	8	3	4	5	2	7	2	3	6	7	2	2	9	9	9	3	9	9
2	2	8	1	4	3	2	9	5	1	2	4	4	4	2	8	5	8	6	9
4	4	8	3	5	8	3	8	2	5	5	6	9	1	1	2	2	5	8	1
1	9	3	9	8	4	4	9	1	2	6	2	1	6	3	1	6	3	3	9
5	9	3	3	4	6	4	8	2	8	2	5	2	8	2	6	2	1	5	7
5	1	1	1	3	6	1	8	5	7	1	9	3	1	6	6	8	9	8	1
3	1	3	1	1	3	7	7	2	3	4	3	2	1	8	1	2	7	1	3
6	9	7	4	2	3	6	S	9	1	4	3	9	3	5	6	1	4	1	2
6	8	9	7	4	6	8	3	5	3	8	9	9	9	3	1	1	6	5	7
9	3	6	6	6	6	3	8	8	4	5	8	6	6	3	6	9	3	4	3
9	8	4	9	3	7	6	7	9	8	6	3	7	7	5	2	9	4	8	4
3	9	8	2	1	6	4	3	1	6	4	5	8	1	4	2	7	5	1	5
9	9	4	4	5	1	6	1	1	7	1	5	2	3	9	7	6	3	2	1
1	1	2	4	2	1	7	1	1	8	1	1	8	7	6	6	1	1	6	1
9	8	6	5	8	2	4	6	1	7	3	5	9	6	4	3	9	9	5	9
2	8	2	9	5	9	8	3	1	7	1	8	2	6	4	9	8	6	9	5
